20 20
####################
#    #             #
# @  #             #
#    ##            #
#     #######^     #
#           #      #
#           ####   #
#              #   #
#              #   #
#              #   #
#   &          #   #
#   &          #   #
#             ^#  @#
#           ####   #
#           # ^    #
#           ####   #
#              #   #
#    ^         #   #
#                  #
####################